11011111

11110111

01101111

10111101

01011111

10111001

11101101

11111101

01011111

10011111

11100111

11101110

01111111

10011110

11111010

11101110

